Layla Joy called me this morning.

Man, last time I saw that innocent little thing, I was a senior and she was a freshman and she was still trying to figure out how boobs work. She must be just barely eighteen by now. Anyway, she was sobbing on the phone, hysterical. Something happened to her back in that little dead-end town we once both called home. Something awful. I had the good sense to not ask for details. But I knew, whatever it was, it meant she had to get the hell out of there, fast. Well, I know a thing or two about how that goes. And there ain't much good I can say about growing up in Texas, but one thing I learned for sure is to always take care of a friend in need. So I told her, "Girl, don't waste one more minute. I've got a place of my own, and a couch you can stay on for as long as you need. Get your ass to Los Angeles."

Here's the thing, though. My lifestyle might be a little more, shall we say, "racey" than a girl like Layla Joy can handle. That's the whole reason I left, after all. It's just how I'm wired. There's the kind of girls who belong in home towns, and there's the kind of girls that belong out here on the Sunset Strip.

That apartment of mine, for example. It doesn't come cheap. And today's the first of the month. That's both good news and bad. The good news is that it means the fellas just got their paychecks. The bad news is that rent is due, and I'm short. By a full grand. So unless I want both LJ and myself to be sleeping on the beach this weekend, I know what I've got to do. Work.

The Rabbit's Tail
An Interactive Fiction by Evangeline Erotica
Release 1 / Serial number 160303 / Inform 7 build 6M62 (I6/v6.33 lib 6/12N) SD

Stage
The stage of The Rabbit's Tail, for better or worse, affords the dancer a view of the entire club floor. That includes her own backside, what with the floor-to-ceiling mirrors squaring off in the corners. When she's grinding against that giant brass pole, the scene from below makes her look like a small army of synchronized sexlings, a kaleidoscope of tits and legs and lips of both kinds.

At the moment, that dancer is me. As the ever-present speakers blast out their meaningless tunes, I shake and gyrate beneath the glare of the blinding stage lights. Whether the club is empty or packed, I know everyone's eyes are on me up here. I'd be lying if I said I didn't kinda love it.

You can see a dry denim rag here.

>l rag
A dry denim rag for wiping down the stage between sets.

>time
That's not a verb I recognise.

>check time
You can't see any such thing.

>t rag
That's not a verb I recognise.

>take rag
Taken.

>use rag
That's not a verb I recognise.

>wipe stage
You can't see any such thing.

>wipe pole
You rub the pole.

>wipe pole with rag
I only understood you as far as wanting to wipe the pole.

>look at pole
Dancers are expected to take the demin rag and give the pole a quick courtesy wipe for the next girl when their set finishes. Otherwise, the brass finish gets a little, um, spotty. In practice, hardly any ofthe girls ever remember, or care.

>look in mirror
You find nothing of interest.

>look at mirror
Back in Texas, I was an eight. Out here in L.A., I'm, like, a five at best. I'm fit, and I'm tall, and I can pull off some seriously sultry pouts if I do say so myself. But let's face it: the only reason the boys pay to see me is for the simple fact that I'm practically naked.

* * *

>wipe pole
I can't just rub my hand on the pole. I'll get my fingerprint smudges all over it, which kinda defeats the purpose.

>wipe pole with rag
I only understood you as far as wanting to wipe the pole.

* * *

>wipe pole
I can't just rub my hand on the pole. I'll get my fingerprint smudges all over it, which kinda defeats the purpose.

>take rag
Taken.

>wipe pole with rag
I only understood you as far as wanting to wipe the pole.

>wipe pole
I can't just rub my hand on it. I'll get my fingerprint smudges all over it, which kinda defeats the purpose.

* * *

>take rag
Taken.

>rub pole
I can't just rub my hand on the pole. I'll get my fingerprint smudges all over it, which kinda defeats the purpose.

* * *

>wipe pole
I can't just rub my hand on the pole. I'll get my fingerprint smudges all over it, which kinda defeats the purpose.

>clean pole
You rub the pole.

>kiss pole
You can only do that to something animate.

>buff pole
That's not a verb I recognise.

>scrub pole
You rub the pole.

>polish pole
You rub the pole.

* * *

>rub pole
I can't just rub my hand on the pole. I'll get my fingerprint smudges all over it, which kinda defeats the purpose.

I sit down on the stage, prop myself on my elbows, stretch my legs up, and scissor them open and closed.

>take rag
Taken.

* * *

>rub pole
I can't just rub my hand on the pole. I'll get my fingerprint smudges all over it, which kinda defeats the purpose.

I sit down on the stage, prop myself on my elbows, stretch my legs up, and scissor them open and closed.

>look in mirror
You find nothing of interest.

I sit down on the stage, prop myself on my elbows, stretch my legs up, and scissor them open and closed.

>look in the mirror
You find nothing of interest.

I grab the pole with one hand for support and undulate my body in long slow waves.

>examine mirror
Back in Texas, I was a freakin" nine. Out here in L.A., I'm, like, a five at best. I'm fit, and I'm tall, and I can pull off some seriously sultry pouts if I do say so myself. But let's face it: the only reason the boys pay to see me is for the simple fact that I'm practically naked. It's a sad truth, but it's a truth that pays the bills.

I bounce my hips to the tune blasting from the speakers.

>examine
(the dry denim rag)
A dry denim rag for wiping down the stage between sets.

I lie down on the stage, arch my back, and slowly run my hand down my body.

* * *

>rub pole
I can't just rub my hand on the pole. I'll get my fingerprint smudges all over it, which kinda defeats the purpose.

I sit down on the stage, prop myself on my elbows, stretch my legs up, and scissor them open and closed.

>rub stage
Look, there are things around here that are okay to rub, and things that aren't, alright?

I grab the pole with one hand for support and undulate my body in long slow waves.

>look stage
The stage rises a few feet above the club floor. It spans the entire back wall of The Rabbit's Tail. On one end is a short flight of stairs - without them, we'd never be able to climb up here in our giant platform heels.

I sit down on the stage, prop myself on my elbows, stretch my legs up, and scissor them open and closed.

>look
Stage
The stage of The Rabbit's Tail, for better or worse, affords the dancer a view of the entire club floor. That includes her own backside, what with the floor-to-ceiling mirrors squaring off in the corner. When she's grinding against that giant brass pole, the scene from below makes her look like a small army of synchronized sex, a kaleidoscope of tits and legs and lips of both kinds.

You can see a dry denim rag here.

I lie down on the stage, arch my back, and slowly run my hand down my body.

>rub pole
I can't just rub my hand on the pole. I'll get my fingerprint smudges all over it, which kinda defeats the purpose.

I bounce my hips to the tune blasting from the speakers.

>take rag
Taken.

I grab the pole with one hand for support and undulate my body in long slow waves.

>rub pole
I bust out the cloth, and give the pole a quick but vigorous rubdown. Who'm I kidding? This ain't the first time I've done that, and it won't be the last.

I lie down on the stage, arch my back, and slowly run my hand down my body.

* * *

>l
Stage
The stage of The Rabbit's Tail, for better or worse, affords the dancer a view of the entire club floor. That includes her own backside, what with the floor-to-ceiling mirrors squaring off in the corners. When she's grinding against that giant brass pole, the scene from below makes her look like a small army of synchronized sexlings, a kaleidoscope of tits and legs and lips of both kinds.

At the moment, that dancer is me. As the ever-present speakers blast out their meaningless tunes, I shake and gyrate beneath the glare of the blinding stage lights. Whether the club is empty or packed, I know everyone's eyes are on me up here. I'd be lying if I said I didn't kinda love it.

You can see a dry denim rag here.

I grind my crotch against the pole to the beat of the music.

>l mirror
Back in Texas, I was an eight. Out here in L.A., I'm, like, a five at best. I'm fit, and I'm tall, and I can pull off some seriously sultry pouts if I do say so myself. But let's face it: the only reason the boys pay to see me is for the simple fact that I'm practically naked.

>l rag
A dry denim rag for wiping down the stage between sets.

>l pole
Dancers are expected to take the demin rag and give the pole a quick courtesy wipe for the next girl when their set finishes. Otherwise, the brass finish gets a little, um, spotty. In practice, hardly any ofthe girls ever remember, or care.

* * *

>dance
That's not a verb I recognise.

>danceness
That's not a verb I recognise.

* * *

>l
Stage
The stage of The Rabbit's Tail, for better or worse, affords the dancer a view of the entire club floor. That includes her own backside, what with the floor-to-ceiling mirrors squaring off in the corners. When she's grinding against that giant brass pole, the scene from below makes her look like a small army of synchronized sexlings, a kaleidoscope of tits and legs and lips of both kinds.

At the moment, that dancer is me. As the ever-present speakers blast out their meaningless tunes, I shake and gyrate beneath the glare of the blinding stage lights. Whether the club is empty or packed, I know everyone's eyes are on me up here. I'd be lying if I said I didn't kinda love it.

You can see a dry denim rag here.

I lie down on the stage, arch my back, and slowly run my hand down my body.

>l
Stage
The stage of The Rabbit's Tail, for better or worse, affords the dancer a view of the entire club floor. That includes her own backside, what with the floor-to-ceiling mirrors squaring off in the corners. When she's grinding against that giant brass pole, the scene from below makes her look like a small army of synchronized sexlings, a kaleidoscope of tits and legs and lips of both kinds.

At the moment, that dancer is me. As the ever-present speakers blast out their meaningless tunes, I shake and gyrate beneath the glare of the blinding stage lights. Whether the club is empty or packed, I know everyone's eyes are on me up here. I'd be lying if I said I didn't kinda love it.

You can see a dry denim rag here.

I lie down on the stage, arch my back, and slowly run my hand down my body.

>l
Stage
The stage of The Rabbit's Tail, for better or worse, affords the dancer a view of the entire club floor. That includes her own backside, what with the floor-to-ceiling mirrors squaring off in the corners. When she's grinding against that giant brass pole, the scene from below makes her look like a small army of synchronized sexlings, a kaleidoscope of tits and legs and lips of both kinds.

At the moment, that dancer is me. As the ever-present speakers blast out their meaningless tunes, I shake and gyrate beneath the glare of the blinding stage lights. Whether the club is empty or packed, I know everyone's eyes are on me up here. I'd be lying if I said I didn't kinda love it.

You can see a dry denim rag here.

I grind my crotch against the pole to the beat of the music.
A figure below me stretches out an arm. With the stage lights in my eyes, all I can see is a silhouette attached to an offered dollar bill. It could be a customer, it could be one of the other girls, it could even be the manager. I don't care. I spread my lips and let them slide in the greenback, before transferring it down to my ankle clip with a coy murmur of, "Thank you, baby."

[Your score has just gone up by one point.]

>l
Stage
The stage of The Rabbit's Tail, for better or worse, affords the dancer a view of the entire club floor. That includes her own backside, what with the floor-to-ceiling mirrors squaring off in the corners. When she's grinding against that giant brass pole, the scene from below makes her look like a small army of synchronized sexlings, a kaleidoscope of tits and legs and lips of both kinds.

At the moment, that dancer is me. As the ever-present speakers blast out their meaningless tunes, I shake and gyrate beneath the glare of the blinding stage lights. Whether the club is empty or packed, I know everyone's eyes are on me up here. I'd be lying if I said I didn't kinda love it.

You can see a dry denim rag here.

I bounce my hips to the tune blasting from the speakers.
A figure below me stretches out an arm. With the stage lights in my eyes, all I can see is a silhouette attached to an offered dollar bill. It could be a customer, it could be one of the other girls, it could even be the manager. I don't care. I spread my ass cheeks and let them slide in the greenback, before transferring it down to my ankle clip with a coy murmur of, "Thank you, baby."

[Your score has just gone up by one point.]

>l
Stage
The stage of The Rabbit's Tail, for better or worse, affords the dancer a view of the entire club floor. That includes her own backside, what with the floor-to-ceiling mirrors squaring off in the corners. When she's grinding against that giant brass pole, the scene from below makes her look like a small army of synchronized sexlings, a kaleidoscope of tits and legs and lips of both kinds.

At the moment, that dancer is me. As the ever-present speakers blast out their meaningless tunes, I shake and gyrate beneath the glare of the blinding stage lights. Whether the club is empty or packed, I know everyone's eyes are on me up here. I'd be lying if I said I didn't kinda love it.

You can see a dry denim rag here.

I grind my crotch against the pole to the beat of the music.

* * *

>l
Stage
The stage of The Rabbit's Tail, for better or worse, affords the dancer a view of the entire club floor. That includes her own backside, what with the floor-to-ceiling mirrors squaring off in the corners. When she's grinding against that giant brass pole, the scene from below makes her look like a small army of synchronized sexlings, a kaleidoscope of tits and legs and lips of both kinds.

At the moment, that dancer is me. As the ever-present speakers blast out their meaningless tunes, I shake and gyrate beneath the glare of the blinding stage lights. Whether the club is empty or packed, I know everyone's eyes are on me up here. I'd be lying if I said I didn't kinda love it.

You can see a dry denim rag here.

I bounce my hips to the tune blasting from the speakers.
A figure below me stretches out an arm. With the stage lights in my eyes, all I can see is a silhouette attached to an offered dollar bill. It could be a customer, it could be one of the other girls, it could even be the manager. I don't care. I spread my lips and let them slide in the greenback, before transferring it down to my ankle clip with a coy murmur of, "Thank you, baby."

[Your score has just gone up by one point.]

* * *

>look in mirror
You find nothing of interest.

I grab the pole with one hand for support and undulate my body in long slow waves.

>look in the mirror
You find nothing of interest.

I bounce my hips to the tune blasting from the speakers.

>examine mirror
Back in Texas, I was a freakin" nine. Out here in L.A., I'm, like, a five at best. I'm fit, and I'm tall, and I can pull off some seriously sultry pouts if I do say so myself. But let's face it: the only reason the boys pay to see me is for the simple fact that I'm practically naked. It's a sad truth, but it's a truth that pays the bills.

I grind my crotch against the pole to the beat of the music.

* * *

>i
You are carrying:
  an ankle clip (being worn)
  a pair of platform heels (being worn)

I bounce my hips to the tune blasting from the speakers.
A figure below me stretches out an arm. With the stage lights in my eyes, all I can see is a silhouette attached to an offered dollar bill. It could be a customer, it could be one of the other girls, it could even be the manager. I don't care. I spread my ass cheeks and let them slide in the greenback, before transferring it down to my ankle clip with a coy murmur of, "Thank you, baby."

[Your score has just gone up by one point.]

>look clip
I have a fancy ankle bracelet specially designed for holding money. RIght now I'm carrying $1 in it.

I grab the pole with one hand for support and undulate my body in long slow waves.
A figure below me stretches out an arm. With the stage lights in my eyes, all I can see is a silhouette attached to an offered dollar bill. It could be a customer, it could be one of the other girls, it could even be the manager. I don't care. I spread my lips and let them slide in the greenback, before transferring it down to my ankle clip with a coy murmur of, "Thank you, baby."

[Your score has just gone up by one point.]

>look clip
I have a fancy ankle bracelet specially designed for holding money. RIght now I'm carrying $2 in it.

I grab the pole with one hand for support and undulate my body in long slow waves.
A figure below me stretches out an arm. With the stage lights in my eyes, all I can see is a silhouette attached to an offered dollar bill. It could be a customer, it could be one of the other girls, it could even be the manager. I don't care. I spread my ass cheeks and let them slide in the greenback, before transferring it down to my ankle clip with a coy murmur of, "Thank you, baby."

[Your score has just gone up by one point.]

>look clip
I have a fancy ankle bracelet specially designed for holding money. RIght now I'm carrying $3 in it.

I lie down on the stage, arch my back, and slowly run my hand down my body.

>remove clip
You take off the ankle clip.

I grind my crotch against the pole to the beat of the music.

>i
You are carrying:
  an ankle clip
  a pair of platform heels (being worn)

I lie down on the stage, arch my back, and slowly run my hand down my body.

* * *

>i
You are carrying:
  an ankle clip (being worn)
  a pair of platform heels (being worn)

I bounce my hips to the tune blasting from the speakers.
A figure below me stretches out an arm. With the stage lights in my eyes, all I can see is a silhouette attached to an offered dollar bill. It could be a customer, it could be one of the other girls, it could even be the manager. I don't care. I spread my ass cheeks and let them slide in the greenback, before transferring it down to my ankle clip with a coy murmur of, "Thank you, baby."

[Your score has just gone up by one point.]

>remove clip
No way, Jose. That ankle clip is holding my money right where I can see it - and that dough is the whole reason I'm here tonight. Or, you know, ever.

I grind my crotch against the pole to the beat of the music.

>remove heels
Look, the platform heels add eight freaking inches to my height. That's empowering as all hell, yo. If I was to pad around barefoot around here, I'd just be a tiny, scared, unnoticeable little thing. And that's what real life is like. No thank you. In here, I can be something more. So the shoes stay on unless there's a damn good reason to take them off.

I grind my crotch against the pole to the beat of the music.

* * *

>rub stage
You can't see any such thing.

>rub pole
I can't just rub my hand on the pole. I'll get my fingerprint smudges all over it, which kinda defeats the purpose.

I lie down on the stage, arch my back, and slowly run my hand down my body.

>take rag
Taken.

I bounce my hips to the tune blasting from the speakers.

>rub pole
I can't just rub my hand on the pole. I'll get my fingerprint smudges all over it, which kinda defeats the purpose.
I bust out the cloth, and give the pole a quick but vigorous rubdown. Who'm I kidding? This ain't the first time I've done that, and it won't be the last.

I bounce my hips to the tune blasting from the speakers.

* * *

>look in mirror
You find nothing of interest.

I bounce my hips to the tune blasting from the speakers.

>look in floor
You can't see any such thing.

>look in ceiling
You can't see any such thing.

>look in pole
You find nothing of interest.

I bounce my hips to the tune blasting from the speakers.

* * *

>look at the pole
Dancers are expected to take the denim rag and give the pole a quick courtesy wipe for the next girl when their set finishes. Otherwise, the brass finish gets a little, um, spotty. In practice, hardly any of the girls ever remember, or care.

I bounce my hips to the tune blasting from the speakers.

>look at the mirror
Back in Texas, I was a freakin" nine. Out here in L.A., I'm, like, a five at best. I'm fit, and I'm tall, and I can pull off some seriously sultry pouts if I do say so myself. But let's face it: the only reason the boys pay to see me is for the simple fact that I'm practically naked. It's a sad truth, but it's a truth that pays the bills.

I grab the pole with one hand for support and undulate my body in long slow waves.

>look in the mirror
You find nothing of interest.

I sit down on the stage, prop myself on my elbows, stretch my legs up, and scissor them open and closed.

>rub pole
Look, there are things around here that are okay to rub, and things that aren't, alright?

I sit down on the stage, prop myself on my elbows, stretch my legs up, and scissor them open and closed.

* * *

>l clock
In giant red digital squarish numbers, the clock glows out 8:00 pm.

I sit down on the stage, prop myself on my elbows, stretch my legs up, and scissor them open and closed.

>l clock
In giant red digital squarish numbers, the clock glows out 8:01 pm.

I bounce my hips to the tune blasting from the speakers.

* * *

>score
You have so far scored 0 out of a possible 1000, in 1 turn.

>l
Stage
The stage of The Rabbit's Tail, for better or worse, affords the dancer a view of the entire club floor. That includes her own backside, what with the floor-to-ceiling mirrors squaring off in the corners. When she's grinding against that giant brass pole, the scene from below makes her look like a small army of synchronized sexlings, a kaleidoscope of tits and legs and lips of both kinds.

At the moment, that dancer is me. As the ever-present speakers blast out their meaningless tunes, I shake and gyrate beneath the glare of the blinding stage lights. Whether the club is empty or packed, I know everyone's eyes are on me up here. I'd be lying if I said I didn't kinda love it.

You can see a dry denim rag here.

I bounce my hips to the tune blasting from the speakers.

* * *

>look at man
You can't see any such thing.

>look at meen
You can't see any such thing.

>look at men
You can't see any such thing.

>examine mn
You can't see any such thing.

>examine man
You can't see any such thing.

* * *

>i
You are carrying:
  an ankle clip (being worn)
  a pair of platform heels (being worn)

I bounce my hips to the tune blasting from the speakers.

>look at clip
You see nothing special about the ankle clip.

I sit down on the stage, prop myself on my elbows, stretch my legs up, and scissor them open and closed.

* * *

>l everything
You can't use multiple objects with that verb.

>l stage
Which do you mean, the main stage or the stage lights?

>l main stage
The stage rises a few feet above the club floor. It spans the entire back wall of The Rabbit's Tail. On one end is a short flight of stairs - without them, we'd never be able to climb up here in our giant platform heels.

I grab the pole with one hand for support and undulate my body in long slow waves.

>l lights
The stage lights are blinding. It isn't just to show off the girls, though - it's also to keep the girls from being able to see the customers. That's intentional. You ever heard the expression, "Dance like nobody's watching?" Well, when you're literally naked on stage... to be honest, yeah, I'll admit, it kinda helps.

I bounce my hips to the tune blasting from the speakers.
A figure below me stretches out an arm. With the stage lights in my eyes, all I can see is a silhouette attached to an offered dollar bill. It could be a customer, it could be one of the other girls, it could even be the manager. I don't care. I part my tits and let them slide in the greenback, before transferring it down to my ankle clip with a coy murmur of, "Thank you, baby."

[Your score has just gone up by one point.]

>l rag
A dry denim rag for wiping down the stage between sets.

I lie down on the stage, arch my back, and slowly run my hand down my body.

>l steps
A short flight of stairs leads down to the club's open floor.

I lie down on the stage, arch my back, and slowly run my hand down my body.
A figure below me stretches out an arm. With the stage lights in my eyes, all I can see is a silhouette attached to an offered dollar bill. It could be a customer, it could be one of the other girls, it could even be the manager. I don't care. I spread my lips and let them slide in the greenback, before transferring it down to my ankle clip with a coy murmur of, "Thank you, baby."

[Your score has just gone up by one point.]

>d
Floor

>l
Floor

>u
Stage
The stage of The Rabbit's Tail, for better or worse, affords the dancer a view of the entire club floor. That includes her own backside, what with the floor-to-ceiling mirrors squaring off in the corners. When she's grinding against that giant brass pole, the scene from below makes her look like a small army of synchronized sexlings, a kaleidoscope of tits and legs and lips of both kinds.

At the moment, that dancer is me. As the ever-present speakers blast out their meaningless tunes, I shake and gyrate beneath the glare of the blinding stage lights. Whether the club is empty or packed, I know everyone's eyes are on me up here. I'd be lying if I said I didn't kinda love it.

You can see a dry denim rag here.

I bounce my hips to the tune blasting from the speakers.

>d
Floor

* * *

>l
Floor

>u
Stage
The stage of The Rabbit's Tail, for better or worse, affords the dancer a view of the entire club floor. That includes her own backside, what with the floor-to-ceiling mirrors squaring off in the corners. When she's grinding against that giant brass pole, the scene from below makes her look like a small army of synchronized sexlings, a kaleidoscope of tits and legs and lips of both kinds.

At the moment, that dancer is me. As the ever-present speakers blast out their meaningless tunes, I shake and gyrate beneath the glare of the blinding stage lights. Whether the club is empty or packed, I know everyone's eyes are on me up here. I'd be lying if I said I didn't kinda love it.

You can see a dry denim rag here.

I sit down on the stage, prop myself on my elbows, stretch my legs up, and scissor them open and closed.

>climb stairs
Little is to be achieved by that.

I lie down on the stage, arch my back, and slowly run my hand down my body.

>walk down stairs
I only understood you as far as wanting to walk down.